-----------
-Sooooooo--
-o-o---o---
-o-ooooooo-
-o-o-----o-
-o-oo--ooo-
-o--oooo-o-
-o---o-ooo-
-o---o--o--
-ooooooooE-
-----------
